Rk,Player,Pos,Age,Tm,G,GS,MP,FG,FGA,FG%,3P,3PA,3P%,2P,2PA,2P%,eFG%,FT,FTA,FT%,ORB,DRB,TRB,AST,STL,BLK,TOV,PF,PTS
1,Precious Achiuwa,C,23,TOR,47,11,1004,161,340,0.474,21,85,0.247,140,255,0.549,0.504,81,116,0.698,86,194,280,46,26,27,52,92,424
2,Steven Adams,C,29,MEM,42,42,1133,157,263,0.597,0,1,0,157,262,0.599,0.597,47,129,0.364,214,271,485,97,36,46,79,98,361
3,Bam Adebayo,C,25,MIA,68,68,2389,563,1037,0.543,1,12,0.083,562,1025,0.548,0.543,305,380,0.803,165,471,636,223,81,59,176,195,1432
4,Ochai Agbaji,SG,22,UTA,48,11,878,112,245,0.457,60,157,0.382,52,88,0.591,0.58,29,38,0.763,33,57,90,37,12,8,23,76,313
5,Santi Aldama,PF,22,MEM,68,18,1495,225,480,0.469,86,247,0.348,139,233,0.597,0.558,95,129,0.736,76,248,324,85,39,45,50,129,631
6,Nickeil Alexander-Walker,SG,24,TOT,50,3,778,118,262,0.45,52,137,0.38,66,125,0.528,0.55,38,57,0.667,13,77,90,99,30,19,52,77,326
6,Nickeil Alexander-Walker,SG,24,UTA,36,3,528,83,170,0.488,35,87,0.402,48,83,0.578,0.591,27,39,0.692,8,51,59,76,24,14,45,58,228
6,Nickeil Alexander-Walker,SG,24,MIN,14,0,250,35,92,0.38,17,50,0.34,18,42,0.429,0.473,11,18,0.611,5,26,31,23,6,5,7,19,98
7,Grayson Allen,SG,27,MIL,65,63,1809,226,512,0.441,133,334,0.398,93,178,0.522,0.571,104,115,0.904,57,159,216,150,52,12,68,109,689
8,Jarrett Allen,C,24,CLE,62,62,2048,371,572,0.649,1,9,0.111,370,563,0.657,0.649,147,202,0.728,193,415,608,104,51,75,87,139,890
9,Jose Alvarado,PG,24,NOP,61,10,1310,201,489,0.411,83,247,0.336,118,242,0.488,0.496,65,80,0.813,28,113,141,186,67,10,81,125,550
10,Kyle Anderson,PF,29,MIN,60,44,1665,210,415,0.506,36,86,0.419,174,329,0.529,0.549,96,130,0.738,53,264,317,277,67,53,88,131,552
11,Giannis Antetokounmpo,PF,28,MIL,56,56,1820,623,1142,0.546,45,156,0.288,578,986,0.586,0.565,459,707,0.649,126,538,664,312,41,45,219,179,1750
12,Thanasis Antetokounmpo,SF,30,MIL,28,0,112,6,22,0.273,0,5,0,6,17,0.353,0.273,4,8,0.5,9,19,28,4,2,3,8,13,16
13,Cole Anthony,PG,22,ORL,52,3,1325,228,515,0.443,62,176,0.352,166,339,0.49,0.503,136,153,0.889,39,199,238,203,32,28,75,136,654
14,OG Anunoby,SF,25,TOR,58,58,2072,361,760,0.475,118,305,0.387,243,455,0.534,0.553,133,159,0.836,82,212,294,110,114,42,125,176,973
15,Ryan Arcidiacono,PG,28,TOT,16,1,87,6,17,0.353,5,10,0.5,1,7,0.143,0.5,0,0,,0,11,11,9,3,0,4,11,17
15,Ryan Arcidiacono,PG,28,NYK,11,0,26,1,5,0.2,1,3,0.333,0,2,0,0.3,0,0,,0,4,4,2,2,0,1,3,3
15,Ryan Arcidiacono,PG,28,POR,5,1,61,5,12,0.417,4,7,0.571,1,5,0.2,0.583,0,0,,0,7,7,7,1,0,3,8,14
16,Deni Avdija,SF,22,WAS,69,34,1784,211,499,0.423,58,202,0.287,153,297,0.515,0.481,110,145,0.759,71,359,430,175,57,28,97,191,590
17,Deandre Ayton,C,24,PHO,61,61,1857,487,827,0.589,7,24,0.292,480,803,0.598,0.593,136,181,0.751,161,458,619,111,34,47,111,173,1117
18,Udoka Azubuike,C,23,UTA,27,0,171,30,35,0.857,0,0,,30,35,0.857,0.857,3,10,0.3,18,46,64,7,5,8,11,16,63
19,Marvin Bagley III,C,23,DET,34,19,776,159,299,0.532,10,47,0.213,149,252,0.591,0.548,58,81,0.716,85,139,224,28,14,26,37,71,386
20,Patrick Baldwin Jr.,SF,20,GSW,26,0,210,40,100,0.4,30,77,0.39,10,23,0.435,0.55,4,6,0.667,1,35,36,7,6,4,11,14,114
21,LaMelo Ball,PG,21,CHO,36,36,1268,296,721,0.411,144,383,0.376,152,338,0.45,0.51,102,122,0.836,42,189,231,304,46,11,129,118,838
22,Mo Bamba,C,24,TOT,47,7,762,116,238,0.487,48,123,0.39,68,115,0.591,0.588,41,62,0.661,56,165,221,46,13,42,30,103,321
22,Mo Bamba,C,24,ORL,40,6,681,106,214,0.495,43,108,0.398,63,106,0.594,0.596,35,51,0.686,47,137,184,42,12,38,22,86,290
22,Mo Bamba,C,24,LAL,7,1,81,10,24,0.417,5,15,0.333,5,9,0.556,0.521,6,11,0.545,9,28,37,4,1,4,8,17,31
23,Paolo Banchero,PF,20,ORL,65,65,2200,434,1023,0.424,74,262,0.282,360,761,0.473,0.46,357,481,0.742,73,358,431,235,56,33,178,146,1299
24,Desmond Bane,SG,24,MEM,49,49,1534,371,791,0.469,137,341,0.402,234,450,0.52,0.556,154,174,0.885,35,215,250,207,46,19,108,122,1033
25,Dalano Banton,PG,23,TOR,27,2,251,46,112,0.411,13,46,0.283,33,66,0.5,0.469,15,19,0.789,9,27,36,29,13,12,16,31,120
26,Dominick Barlow,SF,19,SAS,17,0,199,22,42,0.524,0,4,0,22,38,0.579,0.524,10,13,0.769,21,25,46,10,5,7,10,31,54
27,Harrison Barnes,PF,30,SAC,71,71,2330,323,686,0.471,117,314,0.373,206,372,0.554,0.556,301,355,0.848,69,263,332,113,48,10,77,95,1064
28,Scottie Barnes,PF,21,TOR,69,68,2409,415,916,0.453,61,205,0.298,354,711,0.498,0.486,178,230,0.774,165,308,473,326,68,56,140,154,1069
29,RJ Barrett,SG,22,NYK,66,66,2244,465,1068,0.435,112,353,0.317,353,715,0.494,0.488,262,352,0.744,55,281,336,178,29,13,146,164,1304
30,Will Barton,SG,32,TOT,49,0,878,117,313,0.374,56,154,0.364,61,159,0.384,0.463,35,45,0.778,11,111,122,104,21,12,48,48,325
30,Will Barton,SG,32,WAS,40,0,782,110,285,0.386,52,138,0.377,58,147,0.395,0.477,35,45,0.778,10,101,111,95,17,10,45,39,307
30,Will Barton,SG,32,TOR,9,0,96,7,28,0.25,4,16,0.25,3,12,0.25,0.321,0,0,,1,10,11,9,4,2,3,9,18
31,Charles Bassey,C,22,SAS,35,2,508,87,135,0.644,3,8,0.375,84,127,0.661,0.656,22,37,0.595,75,118,193,48,16,33,41,74,199
32,Keita Bates-Diop,SF,27,SAS,56,31,1174,179,357,0.501,38,102,0.373,141,255,0.553,0.555,84,106,0.792,57,139,196,79,39,16,44,56,480
33,Nicolas Batum,PF,34,LAC,68,12,1474,136,330,0.412,102,269,0.379,34,61,0.557,0.567,30,44,0.682,59,215,274,101,45,41,46,134,404
34,Darius Bazley,PF,22,TOT,39,1,579,74,166,0.446,19,49,0.388,55,117,0.47,0.503,37,67,0.552,30,98,128,34,20,31,23,39,204
34,Darius Bazley,PF,22,OKC,36,1,555,71,158,0.449,18,45,0.4,53,113,0.469,0.506,36,65,0.554,29,93,122,32,19,29,22,35,196
34,Darius Bazley,PF,22,PHO,3,0,24,3,8,0.375,1,4,0.25,2,4,0.5,0.438,1,2,0.5,1,5,6,2,1,2,1,4,8
35,Bradley Beal,SG,29,WAS,49,49,1641,440,863,0.51,80,215,0.372,360,648,0.556,0.556,184,218,0.844,39,152,191,264,45,33,143,101,1144
36,Malik Beasley,SG,26,TOT,71,27,1896,335,853,0.393,211,595,0.355,124,258,0.481,0.516,44,55,0.8,31,224,255,114,59,8,80,98,925
36,Malik Beasley,SG,26,UTA,55,13,1472,265,669,0.396,169,471,0.359,96,198,0.485,0.522,37,44,0.841,27,170,197,93,44,8,60,75,736
36,Malik Beasley,SG,26,LAL,16,14,424,70,184,0.38,42,124,0.339,28,60,0.467,0.495,7,11,0.636,4,54,58,21,15,0,20,23,189
37,MarJon Beauchamp,SF,22,MIL,42,9,578,80,206,0.388,38,120,0.317,42,86,0.488,0.481,21,29,0.724,34,58,92,26,18,4,37,60,219
38,D?vis Bert?ns,PF,30,DAL,40,0,433,57,136,0.419,46,120,0.383,11,16,0.688,0.588,10,12,0.833,8,33,41,20,10,6,10,49,170
39,Patrick Beverley,PG,34,TOT,57,57,1565,125,307,0.407,71,205,0.346,54,102,0.529,0.523,44,61,0.721,42,172,214,164,48,35,55,167,365
39,Patrick Beverley,PG,34,LAL,45,45,1211,97,241,0.402,55,158,0.348,42,83,0.506,0.517,39,50,0.78,24,116,140,118,40,25,42,124,288
39,Patrick Beverley,PG,34,CHI,12,12,354,28,66,0.424,16,47,0.34,12,19,0.632,0.545,5,11,0.455,18,56,74,46,8,10,13,43,77
40,Saddiq Bey,SF,23,TOT,66,32,1857,295,711,0.415,130,357,0.364,165,354,0.466,0.506,193,224,0.862,73,223,296,97,60,13,63,109,913
40,Saddiq Bey,SF,23,DET,52,30,1500,245,606,0.404,101,293,0.345,144,313,0.46,0.488,180,209,0.861,59,183,242,84,50,12,54,86,771
40,Saddiq Bey,SF,23,ATL,14,2,357,50,105,0.476,29,64,0.453,21,41,0.512,0.614,13,15,0.867,14,40,54,13,10,1,9,23,142
41,Khem Birch,C,30,TOR,20,0,162,19,32,0.594,1,2,0.5,18,30,0.6,0.609,4,5,0.8,8,17,25,7,5,5,8,24,43
42,Goga Bitadze,C,23,TOT,29,0,301,41,79,0.519,5,19,0.263,36,60,0.6,0.551,15,32,0.469,40,44,84,27,12,16,14,45,102
42,Goga Bitadze,C,23,IND,21,0,202,27,52,0.519,4,14,0.286,23,38,0.605,0.558,11,24,0.458,25,24,49,18,9,10,12,34,69
42,Goga Bitadze,C,23,ORL,8,0,99,14,27,0.519,1,5,0.2,13,22,0.591,0.537,4,8,0.5,15,20,35,9,3,6,2,11,33
43,Bismack Biyombo,C,30,PHO,51,10,691,85,151,0.563,0,0,,85,151,0.563,0.563,17,54,0.315,56,144,200,45,15,64,44,91,187
44,Buddy Boeheim,PG,23,DET,6,0,65,4,22,0.182,4,21,0.19,0,1,0,0.273,2,2,1,2,2,4,3,2,0,0,4,14
45,Bogdan Bogdanovi?,SG,30,ATL,45,5,1273,229,522,0.439,122,301,0.405,107,221,0.484,0.556,53,65,0.815,18,124,142,127,37,16,56,75,633
46,Bojan Bogdanovi?,PF,33,DET,59,59,1893,430,882,0.488,145,353,0.411,285,529,0.539,0.57,268,303,0.884,36,187,223,152,34,8,135,113,1273
47,Bol Bol,PF,23,ORL,67,32,1431,250,442,0.566,29,99,0.293,221,343,0.644,0.598,76,100,0.76,66,321,387,61,27,82,106,88,605
48,Leandro Bolmaro,SG,22,UTA,14,0,68,3,20,0.15,0,4,0,3,16,0.188,0.15,0,0,,4,3,7,7,3,1,7,10,6
49,Devin Booker,SG,26,PHO,44,44,1518,453,913,0.496,99,269,0.368,354,644,0.55,0.55,228,271,0.841,39,159,198,241,40,16,112,131,1233
50,Brandon Boston Jr.,SG,21,LAC,21,1,247,51,121,0.421,12,29,0.414,39,92,0.424,0.471,29,38,0.763,7,22,29,19,9,0,12,21,143
51,Chris Boucher,PF,30,TOR,66,0,1309,224,450,0.498,54,164,0.329,170,286,0.594,0.558,112,150,0.747,139,231,370,27,43,55,35,126,614
52,James Bouknight,SG,22,CHO,26,0,354,40,122,0.328,16,64,0.25,24,58,0.414,0.393,15,22,0.682,5,46,51,28,13,4,19,29,111
53,Jamaree Bouyea,PG,23,TOT,5,0,71,6,14,0.429,2,6,0.333,4,8,0.5,0.5,1,2,0.5,1,5,6,4,4,2,4,6,15
53,Jamaree Bouyea,PG,23,MIA,4,0,65,6,13,0.462,2,5,0.4,4,8,0.5,0.538,1,2,0.5,1,4,5,4,4,2,4,5,15
53,Jamaree Bouyea,PG,23,WAS,1,0,6,0,1,0,0,1,0,0,0,,0,0,0,,0,1,1,0,0,0,0,1,0
54,Tony Bradley,C,25,CHI,12,0,33,6,12,0.5,3,5,0.6,3,7,0.429,0.625,4,4,1,1,10,11,1,1,1,1,2,19
55,Malaki Branham,SF,19,SAS,55,21,1256,206,466,0.442,63,199,0.317,143,267,0.536,0.51,44,54,0.815,25,116,141,110,29,7,65,97,519
56,Christian Braun,SG,21,DEN,66,3,955,111,221,0.502,29,72,0.403,82,149,0.55,0.568,30,48,0.625,39,109,148,49,30,16,29,81,281
57,Mikal Bridges,SF,26,TOT,72,72,2590,494,1046,0.472,144,359,0.401,350,687,0.509,0.541,247,276,0.895,70,245,315,242,80,57,106,144,1379
57,Mikal Bridges,SF,26,PHO,56,56,2040,354,764,0.463,101,261,0.387,253,503,0.503,0.529,156,174,0.897,56,187,243,201,65,45,78,115,965
57,Mikal Bridges,SF,26,BRK,16,16,550,140,282,0.496,43,98,0.439,97,184,0.527,0.573,91,102,0.892,14,58,72,41,15,12,28,29,414
58,Oshae Brissett,SF,24,IND,56,1,916,104,262,0.397,43,135,0.319,61,127,0.48,0.479,76,108,0.704,52,138,190,33,29,11,24,70,327
59,Malcolm Brogdon,PG,30,BOS,60,0,1551,310,639,0.485,121,265,0.457,189,374,0.505,0.58,142,162,0.877,37,217,254,217,37,16,91,98,883
60,Dillon Brooks,SF,27,MEM,65,65,1981,347,888,0.391,124,383,0.324,223,505,0.442,0.461,107,135,0.793,41,173,214,167,57,13,92,212,925
61,Bruce Brown,SG,26,DEN,71,28,1997,303,632,0.479,85,233,0.365,218,399,0.546,0.547,82,110,0.745,51,233,284,238,74,43,112,169,773
62,Greg Brown III,PF,21,POR,16,0,93,11,28,0.393,1,7,0.143,10,21,0.476,0.411,5,12,0.417,2,17,19,3,4,5,6,13,28
63,Jaylen Brown,SF,26,BOS,60,60,2170,602,1228,0.49,150,441,0.34,452,787,0.574,0.551,250,324,0.772,74,339,413,203,71,26,176,161,1604
64,Kendall Brown,SG,19,IND,6,0,40,4,7,0.571,0,1,0,4,6,0.667,0.571,1,2,0.5,2,4,6,3,4,0,2,9,9
65,Moses Brown,C,23,LAC,34,1,288,61,96,0.635,0,0,,61,96,0.635,0.635,33,72,0.458,57,82,139,4,3,14,14,38,155
66,Sterling Brown,SG,27,LAL,4,0,24,0,4,0,0,2,0,0,2,0,0,0,0,,3,5,8,2,3,0,0,4,0
67,Troy Brown Jr.,SF,23,LAL,66,42,1635,178,409,0.435,93,247,0.377,85,162,0.525,0.549,32,35,0.914,58,213,271,81,50,11,45,107,481
68,Jalen Brunson,PG,26,NYK,64,64,2234,543,1116,0.487,123,298,0.413,420,818,0.513,0.542,312,373,0.836,37,189,226,395,57,15,127,144,1521
69,Thomas Bryant,C,25,TOT,55,25,1039,220,352,0.625,24,55,0.436,196,297,0.66,0.659,93,126,0.738,84,243,327,31,16,28,36,98,557
69,Thomas Bryant,C,25,LAL,41,25,876,197,301,0.654,22,50,0.44,175,251,0.697,0.691,80,108,0.741,67,212,279,29,14,23,28,77,496
69,Thomas Bryant,C,25,DEN,14,0,163,23,51,0.451,2,5,0.4,21,46,0.457,0.471,13,18,0.722,17,31,48,2,2,5,8,21,61
70,Reggie Bullock,SF,31,DAL,69,46,2108,170,417,0.408,134,351,0.382,36,66,0.545,0.568,26,37,0.703,32,219,251,98,52,13,32,152,500
71,Alec Burks,SG,31,DET,51,8,1122,200,459,0.436,99,239,0.414,101,220,0.459,0.544,153,188,0.814,19,139,158,114,38,8,58,98,652
72,Deonte Burton,SG,29,SAC,2,0,6,0,2,0,0,1,0,0,1,0,0,0,0,,0,0,0,0,0,0,0,0,0
73,Jared Butler,SG,22,OKC,2,0,19,2,4,0.5,1,2,0.5,1,2,0.5,0.625,0,0,,0,1,1,4,3,0,2,3,5
74,Jimmy Butler,SF,33,MIA,58,58,1932,427,806,0.53,31,93,0.333,396,713,0.555,0.549,430,504,0.853,138,215,353,294,108,21,96,74,1315
75,John Butler,C,20,POR,9,0,30,1,5,0.2,0,4,0,1,1,1,0.2,0,0,,1,1,2,1,1,3,0,2,2
76,Jamal Cain,SF,23,MIA,15,0,186,26,50,0.52,2,12,0.167,24,38,0.632,0.54,12,16,0.75,12,27,39,9,8,0,4,15,66
77,Kentavious Caldwell-Pope,SG,29,DEN,69,69,2188,272,576,0.472,127,293,0.433,145,283,0.512,0.582,92,110,0.836,31,156,187,171,101,31,78,135,763
78,Facundo Campazzo,PG,31,DAL,8,0,52,3,13,0.231,3,11,0.273,0,2,0,0.346,1,2,0.5,0,2,2,9,6,0,3,3,10
79,Vlatko ?an?ar,PF,25,DEN,51,8,802,102,208,0.49,42,105,0.4,60,103,0.583,0.591,30,32,0.938,22,94,116,73,18,12,32,77,276
80,Clint Capela,C,28,ATL,55,53,1464,298,465,0.641,0,1,0,298,464,0.642,0.641,59,101,0.584,229,378,607,48,37,67,45,117,655
81,Vernon Carey Jr.,C,21,WAS,11,0,28,2,8,0.25,0,0,,2,8,0.25,0.25,2,2,1,3,8,11,3,2,2,2,5,6
82,Jevon Carter,PG,27,MIL,71,35,1580,208,486,0.428,120,286,0.42,88,200,0.44,0.551,29,36,0.806,31,151,182,170,64,27,72,142,565
83,Wendell Carter Jr.,C,23,ORL,49,46,1472,285,541,0.527,65,188,0.346,220,353,0.623,0.587,129,174,0.741,111,324,435,118,23,28,102,142,764
84,Alex Caruso,PG,28,CHI,59,28,1417,114,256,0.445,48,133,0.361,66,123,0.537,0.539,56,69,0.812,36,141,177,179,92,38,73,144,332
85,Julian Champagnie,SF,21,TOT,6,0,56,10,21,0.476,7,16,0.438,3,5,0.6,0.643,0,0,,2,8,10,2,1,0,2,4,27
85,Julian Champagnie,SF,21,PHI,2,0,7,0,2,0,0,1,0,0,1,0,0,0,0,,0,0,0,0,1,0,0,0,0
85,Julian Champagnie,SF,21,SAS,4,0,49,10,19,0.526,7,15,0.467,3,4,0.75,0.711,0,0,,2,8,10,2,0,0,2,4,27
86,Justin Champagnie,SF,21,TOR,3,0,11,3,3,1,0,0,,3,3,1,1,0,0,,1,3,4,1,0,0,0,1,6
87,Kennedy Chandler,PG,20,MEM,31,0,245,29,71,0.408,2,14,0.143,27,57,0.474,0.423,6,13,0.462,7,25,32,51,11,5,16,13,66
88,Max Christie,SG,19,LAL,38,3,507,44,105,0.419,26,62,0.419,18,43,0.419,0.543,14,16,0.875,7,67,74,19,9,7,13,33,128
89,Josh Christopher,SG,21,HOU,54,1,622,117,256,0.457,19,73,0.26,98,183,0.536,0.494,39,50,0.78,15,46,61,54,23,12,49,53,292
90,Brandon Clarke,PF,26,MEM,56,8,1090,229,349,0.656,1,6,0.167,228,343,0.665,0.658,99,137,0.723,92,218,310,72,34,37,55,131,558
91,Jordan Clarkson,SG,30,UTA,61,61,1988,458,1031,0.444,155,459,0.338,303,572,0.53,0.519,200,245,0.816,72,174,246,270,33,13,186,120,1271
92,Nic Claxton,C,23,BRK,66,66,1949,357,504,0.708,0,2,0,357,502,0.711,0.708,115,220,0.523,159,447,606,118,53,165,84,186,829
93,Amir Coffey,SG,25,LAC,45,9,593,54,141,0.383,10,38,0.263,44,103,0.427,0.418,46,59,0.78,17,35,52,51,7,3,18,50,164
94,John Collins,PF,25,ATL,61,61,1837,307,607,0.506,52,199,0.261,255,408,0.625,0.549,118,143,0.825,65,336,401,72,38,67,71,194,784
95,Zach Collins,C,25,SAS,58,21,1303,250,480,0.521,49,127,0.386,201,353,0.569,0.572,100,129,0.775,107,257,364,163,33,42,117,183,649
96,Mike Conley,PG,35,TOT,58,57,1749,218,519,0.42,112,298,0.376,106,221,0.48,0.528,111,132,0.841,28,127,155,409,64,13,93,115,659
96,Mike Conley,PG,35,UTA,43,42,1276,153,375,0.408,77,213,0.362,76,162,0.469,0.511,78,96,0.813,17,90,107,330,44,10,74,94,461
96,Mike Conley,PG,35,MIN,15,15,473,65,144,0.451,35,85,0.412,30,59,0.508,0.573,33,36,0.917,11,37,48,79,20,3,19,21,198
97,Pat Connaughton,SG,30,MIL,53,31,1301,147,381,0.386,98,292,0.336,49,89,0.551,0.514,27,41,0.659,41,211,252,69,36,9,29,57,419
98,Xavier Cooks,PF,27,WAS,1,0,6,0,0,,0,0,,0,0,,,0,0,,1,1,2,0,0,0,1,0,0
99,Robert Covington,PF,32,LAC,39,0,645,80,190,0.421,40,116,0.345,40,74,0.541,0.526,27,36,0.75,25,114,139,48,30,29,23,74,227
100,Torrey Craig,SF,32,PHO,68,55,1728,191,432,0.442,87,223,0.39,104,209,0.498,0.543,31,43,0.721,132,249,381,106,46,49,69,159,500
101,Jae Crowder,SF,32,MIL,11,0,206,22,46,0.478,13,33,0.394,9,13,0.692,0.62,9,11,0.818,11,35,46,15,5,4,4,16,66
102,Jarrett Culver,SG,23,ATL,10,1,137,17,43,0.395,1,12,0.083,16,31,0.516,0.407,9,13,0.692,10,28,38,6,6,2,7,14,44
103,Cade Cunningham,PG,21,DET,12,12,400,93,224,0.415,17,61,0.279,76,163,0.466,0.453,36,43,0.837,12,62,74,72,10,7,39,34,239
104,Seth Curry,SG,32,BRK,53,7,1128,196,422,0.464,90,220,0.409,106,202,0.525,0.571,47,48,0.979,13,83,96,94,35,7,48,87,529
105,Stephen Curry,PG,34,GSW,47,47,1633,471,946,0.498,234,541,0.433,237,405,0.585,0.622,225,246,0.915,33,259,292,291,45,17,157,104,1401
106,Dyson Daniels,PG,19,NOP,49,11,912,75,177,0.424,22,73,0.301,53,104,0.51,0.486,22,35,0.629,30,130,160,119,37,11,51,87,194
107,Anthony Davis,C,29,LAL,46,44,1546,443,792,0.559,18,68,0.265,425,724,0.587,0.571,284,356,0.798,155,420,575,116,47,96,108,124,1188
108,Johnny Davis,SG,20,WAS,17,0,119,15,37,0.405,1,8,0.125,14,29,0.483,0.419,4,7,0.571,2,15,17,3,1,2,4,18,35
109,Terence Davis,SG,25,SAC,56,4,737,133,307,0.433,74,199,0.372,59,108,0.546,0.554,32,38,0.842,18,110,128,61,40,12,47,95,372
110,JD Davison,PG,20,BOS,8,0,19,3,11,0.273,0,3,0,3,8,0.375,0.273,0,0,,1,4,5,3,2,0,1,2,6
111,Darius Days,PF,23,HOU,4,0,25,5,12,0.417,3,10,0.3,2,2,1,0.542,2,2,1,1,5,6,1,0,1,0,2,15
112,Dewayne Dedmon,C,33,TOT,33,0,364,68,133,0.511,11,37,0.297,57,96,0.594,0.553,32,46,0.696,28,86,114,18,8,14,20,64,179
112,Dewayne Dedmon,C,33,MIA,30,0,350,64,129,0.496,11,37,0.297,53,92,0.576,0.539,32,44,0.727,28,81,109,16,7,14,19,61,171
112,Dewayne Dedmon,C,33,PHI,3,0,14,4,4,1,0,0,,4,4,1,1,0,2,0,0,5,5,2,1,0,1,3,8
113,Matthew Dellavedova,PG,32,SAC,29,0,185,14,44,0.318,8,24,0.333,6,20,0.3,0.409,4,7,0.571,1,10,11,36,6,0,10,17,40
114,DeMar DeRozan,SF,33,CHI,65,65,2389,597,1167,0.512,39,115,0.339,558,1052,0.53,0.528,420,483,0.87,31,277,308,330,72,33,140,172,1653
115,Moussa Diabat?,PF,21,LAC,18,1,172,21,40,0.525,1,2,0.5,20,38,0.526,0.538,10,16,0.625,29,16,45,3,5,6,9,13,53
116,Mamadi Diakite,PF,26,CLE,18,2,120,13,33,0.394,4,15,0.267,9,18,0.5,0.455,0,0,,5,13,18,4,2,7,8,18,30
117,Hamidou Diallo,SG,24,DET,56,0,996,215,375,0.573,5,21,0.238,210,354,0.593,0.58,87,148,0.588,57,137,194,55,53,16,71,124,522
118,Gorgui Dieng,C,33,SAS,24,1,235,27,75,0.36,12,50,0.24,15,25,0.6,0.44,5,6,0.833,22,42,64,34,4,10,20,36,71
119,Ousmane Dieng,SF,19,OKC,28,0,443,59,140,0.421,22,76,0.289,37,64,0.578,0.5,10,17,0.588,14,68,82,31,11,6,17,34,150
120,Spencer Dinwiddie,PG,29,TOT,69,69,2367,409,920,0.445,167,439,0.38,242,481,0.503,0.535,235,288,0.816,25,201,226,407,59,22,129,166,1220
120,Spencer Dinwiddie,PG,29,DAL,53,53,1808,316,694,0.455,138,341,0.405,178,353,0.504,0.555,170,207,0.821,19,144,163,279,39,16,90,124,940
120,Spencer Dinwiddie,PG,29,BRK,16,16,559,93,226,0.412,29,98,0.296,64,128,0.5,0.476,65,81,0.802,6,57,63,128,20,6,39,42,280
121,Donte DiVincenzo,SG,26,GSW,63,28,1673,202,476,0.424,134,335,0.4,68,141,0.482,0.565,48,57,0.842,66,211,277,216,83,10,93,119,586
122,Luka Don?i?,PG,23,DAL,57,57,2068,629,1257,0.5,158,453,0.349,471,804,0.586,0.563,463,629,0.736,48,443,491,458,83,28,209,148,1879
123,Tyler Dorsey,SG,26,DAL,3,0,8,4,5,0.8,1,2,0.5,3,3,1,0.9,0,0,,1,1,2,0,0,0,0,0,9
124,Luguentz Dort,SG,23,OKC,64,63,1943,302,755,0.4,122,354,0.345,180,401,0.449,0.481,172,220,0.782,97,181,278,141,65,20,83,206,898
125,Ayo Dosunmu,SG,23,CHI,69,50,1847,247,498,0.496,51,163,0.313,196,335,0.585,0.547,60,74,0.811,43,156,199,181,51,24,88,166,605
126,Devon Dotson,PG,23,WAS,6,0,53,1,10,0.1,1,4,0.25,0,6,0,0.15,0,0,,6,4,10,8,5,0,3,9,3
127,Jeff Dowtin,PG,25,TOR,18,0,159,19,43,0.442,3,11,0.273,16,32,0.5,0.477,3,4,0.75,6,11,17,17,4,1,5,10,44
128,PJ Dozier,SG,26,SAC,9,0,18,3,8,0.375,1,5,0.2,2,3,0.667,0.438,0,0,,0,5,5,0,3,0,1,2,7
129,Goran Dragi?,PG,36,CHI,51,0,787,127,299,0.425,45,128,0.352,82,171,0.48,0.5,27,41,0.659,13,56,69,139,11,4,56,63,326
130,Andre Drummond,C,29,CHI,58,0,734,142,234,0.607,0,2,0,142,232,0.612,0.607,56,104,0.538,117,261,378,31,38,20,67,109,340
131,Chris Duarte,SF,25,IND,45,12,892,123,331,0.372,55,173,0.318,68,158,0.43,0.455,61,72,0.847,19,96,115,63,24,9,40,65,362
132,David Duke Jr.,SG,23,BRK,18,0,173,28,61,0.459,1,8,0.125,27,53,0.509,0.467,5,9,0.556,8,12,20,16,7,1,14,27,62
133,Kris Dunn,PG,28,UTA,11,0,251,52,100,0.52,10,22,0.455,42,78,0.538,0.57,15,18,0.833,6,41,47,59,15,6,15,33,129
134,Kevin Durant,PF-SF,34,TOT,42,42,1501,439,776,0.566,78,202,0.386,361,574,0.629,0.616,282,303,0.931,15,269,284,218,33,61,142,97,1238
134,Kevin Durant,PF,34,BRK,39,39,1403,410,734,0.559,71,189,0.376,339,545,0.622,0.607,267,286,0.934,14,248,262,207,32,57,136,92,1158
134,Kevin Durant,SF,34,PHO,3,3,98,29,42,0.69,7,13,0.538,22,29,0.759,0.774,15,17,0.882,1,21,22,11,1,4,6,5,80
135,Jalen Duren,C,19,DET,58,27,1424,213,336,0.634,0,2,0,213,334,0.638,0.634,79,128,0.617,197,310,507,65,36,53,74,154,505
136,Tari Eason,PF,21,HOU,72,5,1497,257,563,0.456,52,148,0.351,205,415,0.494,0.503,97,131,0.74,163,259,422,71,84,42,85,163,663
137,Anthony Edwards,SG,21,MIN,71,71,2558,636,1380,0.461,193,520,0.371,443,860,0.515,0.531,290,378,0.767,39,378,417,315,114,51,237,172,1755
138,Kessler Edwards,SF,22,TOT,24,3,231,21,57,0.368,10,33,0.303,11,24,0.458,0.456,7,10,0.7,13,23,36,10,5,2,9,21,59
138,Kessler Edwards,SF,22,BRK,14,1,79,6,24,0.25,2,12,0.167,4,12,0.333,0.292,1,2,0.5,6,8,14,2,3,1,4,3,15
138,Kessler Edwards,SF,22,SAC,10,2,152,15,33,0.455,8,21,0.381,7,12,0.583,0.576,6,8,0.75,7,15,22,8,2,1,5,18,44
139,Keon Ellis,SG,23,SAC,12,0,45,7,13,0.538,6,10,0.6,1,3,0.333,0.769,2,3,0.667,4,4,8,3,3,1,1,7,22
140,Joel Embiid,C,28,PHI,58,58,2030,647,1186,0.546,61,174,0.351,586,1012,0.579,0.571,591,691,0.855,105,490,595,238,62,102,201,186,1946
141,Drew Eubanks,C,25,POR,69,20,1356,174,255,0.682,3,7,0.429,171,248,0.69,0.688,68,103,0.66,110,242,352,84,32,79,54,150,419
142,Bruno Fernando,C,24,TOT,34,4,372,50,96,0.521,0,1,0,50,95,0.526,0.521,30,44,0.682,49,75,124,31,6,31,22,69,130
142,Bruno Fernando,C,24,HOU,31,4,364,48,93,0.516,0,1,0,48,92,0.522,0.516,30,44,0.682,48,74,122,30,6,31,20,68,126
142,Bruno Fernando,C,24,ATL,3,0,8,2,3,0.667,0,0,,2,3,0.667,0.667,0,0,,1,1,2,1,0,0,2,1,4
143,Dorian Finney-Smith,PF,29,TOT,57,57,1781,169,431,0.392,99,298,0.332,70,133,0.526,0.507,39,52,0.75,95,175,270,89,50,27,52,125,476
143,Dorian Finney-Smith,PF,29,DAL,40,40,1288,129,310,0.416,77,217,0.355,52,93,0.559,0.54,30,40,0.75,67,121,188,59,38,20,36,80,365
143,Dorian Finney-Smith,PF,29,BRK,17,17,493,40,121,0.331,22,81,0.272,18,40,0.45,0.421,9,12,0.75,28,54,82,30,12,7,16,45,111
144,Malachi Flynn,PG,24,TOR,46,1,598,75,206,0.364,42,115,0.365,33,91,0.363,0.466,17,24,0.708,15,53,68,65,18,3,19,56,209
145,Simone Fontecchio,SF,27,UTA,42,2,530,74,206,0.359,45,134,0.336,29,72,0.403,0.468,29,36,0.806,23,34,57,31,11,8,28,43,222
146,Bryn Forbes,SG,29,MIN,25,0,268,30,83,0.361,14,46,0.304,16,37,0.432,0.446,15,15,1,4,11,15,17,7,2,12,22,89
147,Trent Forrest,PG,24,ATL,18,3,239,24,50,0.48,0,2,0,24,48,0.5,0.48,2,3,0.667,5,24,29,31,6,2,10,16,50
148,Michael Foster Jr.,PF,20,PHI,1,0,1,0,0,,0,0,,0,0,,,0,0,,0,0,0,0,0,0,0,0,0
149,Evan Fournier,SG,30,NYK,23,7,414,53,151,0.351,33,102,0.324,20,49,0.408,0.46,18,21,0.857,4,41,45,35,14,3,19,43,157
150,De'Aaron Fox,PG,25,SAC,64,64,2179,608,1178,0.516,108,317,0.341,500,861,0.581,0.562,306,398,0.769,33,240,273,395,77,20,167,158,1630
151,Markelle Fultz,PG,24,ORL,51,51,1533,294,577,0.51,22,70,0.314,272,507,0.536,0.529,106,133,0.797,66,143,209,289,78,20,122,115,716
152,Wenyen Gabriel,PF,25,LAL,58,2,891,142,237,0.599,9,31,0.29,133,206,0.646,0.618,46,73,0.63,107,143,250,30,21,31,39,128,339
153,Daniel Gafford,C,24,WAS,69,38,1362,239,322,0.742,0,0,,239,322,0.742,0.742,106,161,0.658,139,230,369,72,30,86,70,155,584
154,Darius Garland,PG,23,CLE,62,62,2182,473,1007,0.47,159,382,0.416,314,625,0.502,0.549,255,299,0.853,26,143,169,486,79,7,179,132,1360
155,Usman Garuba,PF,20,HOU,65,1,853,80,154,0.519,24,47,0.511,56,107,0.523,0.597,26,44,0.591,105,172,277,57,40,26,43,111,210
156,Luka Garza,C,24,MIN,26,0,235,61,111,0.55,14,38,0.368,47,73,0.644,0.613,41,52,0.788,31,29,60,18,3,2,13,41,177
157,Rudy Gay,PF,36,UTA,55,0,806,107,282,0.379,31,126,0.246,76,156,0.487,0.434,41,47,0.872,33,129,162,56,19,18,37,68,286
158,Paul George,SG,32,LAC,55,55,1904,450,987,0.456,158,421,0.375,292,566,0.516,0.536,256,292,0.877,44,291,335,283,80,19,174,157,1314
159,Taj Gibson,C,37,WAS,45,2,431,60,110,0.545,4,19,0.211,56,91,0.615,0.564,26,38,0.684,30,58,88,32,14,11,22,78,150
160,Josh Giddey,SG,20,OKC,66,66,2035,460,950,0.484,62,190,0.326,398,760,0.524,0.517,85,114,0.746,133,384,517,405,51,27,192,131,1067
161,Shai Gilgeous-Alexander,PG,24,OKC,60,60,2135,624,1222,0.511,52,148,0.351,572,1074,0.533,0.532,584,646,0.904,54,233,287,330,102,60,173,163,1884
162,Anthony Gill,PF,30,WAS,48,5,478,54,94,0.574,3,22,0.136,51,72,0.708,0.59,40,49,0.816,29,46,75,23,6,11,11,58,151
163,Rudy Gobert,C,30,MIN,61,61,1869,326,488,0.668,0,3,0,326,485,0.672,0.668,194,300,0.647,197,502,699,66,50,86,105,182,846
164,Jordan Goodwin,PG,24,WAS,51,4,858,112,249,0.45,29,79,0.367,83,170,0.488,0.508,37,49,0.755,45,112,157,119,46,22,43,79,290
165,Aaron Gordon,PF,27,DEN,60,60,1807,383,662,0.579,54,152,0.355,329,510,0.645,0.619,178,287,0.62,144,253,397,176,46,44,89,113,998
166,Eric Gordon,SG,34,TOT,60,50,1756,259,582,0.445,111,305,0.364,148,277,0.534,0.54,130,160,0.813,15,105,120,166,39,24,92,69,759
166,Eric Gordon,SG,34,HOU,47,47,1418,210,478,0.439,85,245,0.347,125,233,0.536,0.528,110,135,0.815,12,85,97,136,30,17,83,45,615
166,Eric Gordon,SG,34,LAC,13,3,338,49,104,0.471,26,60,0.433,23,44,0.523,0.596,20,25,0.8,3,20,23,30,9,7,9,24,144
167,Devonte' Graham,PG,27,TOT,66,6,1178,145,378,0.384,108,298,0.362,37,80,0.463,0.526,84,109,0.771,18,90,108,176,39,15,44,69,482
167,Devonte' Graham,PG,27,NOP,53,0,811,85,231,0.368,66,190,0.347,19,41,0.463,0.511,44,59,0.746,12,60,72,116,30,10,27,48,280
167,Devonte' Graham,PG,27,SAS,13,6,367,60,147,0.408,42,108,0.389,18,39,0.462,0.551,40,50,0.8,6,30,36,60,9,5,17,21,202
168,Jerami Grant,PF,28,POR,63,63,2246,434,913,0.475,144,359,0.401,290,554,0.523,0.554,278,342,0.813,53,230,283,150,51,53,116,152,1290
169,A.J. Green,SG,23,MIL,32,0,302,48,109,0.44,39,91,0.429,9,18,0.5,0.619,4,4,1,5,33,38,19,6,0,9,29,139
170,Danny Green,SG,35,TOT,9,0,88,9,23,0.391,8,18,0.444,1,5,0.2,0.565,1,1,1,2,5,7,2,3,1,6,10,27
170,Danny Green,SG,35,MEM,3,0,43,3,11,0.273,3,8,0.375,0,3,0,0.409,0,0,,1,3,4,2,1,0,3,6,9
170,Danny Green,SG,35,CLE,6,0,45,6,12,0.5,5,10,0.5,1,2,0.5,0.708,1,1,1,1,2,3,0,2,1,3,4,18
171,Draymond Green,PF,32,GSW,64,64,2015,215,407,0.528,36,110,0.327,179,297,0.603,0.572,69,98,0.704,55,414,469,432,61,49,166,196,535
172,Jalen Green,SG,20,HOU,66,66,2251,488,1186,0.411,166,494,0.336,322,692,0.465,0.481,305,386,0.79,38,219,257,234,51,18,183,118,1447
173,JaMychal Green,PF,32,GSW,53,1,759,127,239,0.531,40,107,0.374,87,132,0.659,0.615,49,64,0.766,68,128,196,50,24,22,52,102,343
174,Javonte Green,SG,29,CHI,29,1,458,61,104,0.587,13,34,0.382,48,70,0.686,0.649,29,43,0.674,25,58,83,23,23,20,20,48,164
175,Jeff Green,PF,36,DEN,48,3,925,140,281,0.498,23,82,0.28,117,199,0.588,0.539,67,92,0.728,32,90,122,56,17,15,42,86,370
176,Josh Green,SG,22,DAL,52,19,1335,186,347,0.536,62,153,0.405,124,194,0.639,0.625,64,89,0.719,48,105,153,93,37,4,63,141,498
177,AJ Griffin,SF,19,ATL,63,11,1222,219,467,0.469,87,229,0.38,132,238,0.555,0.562,36,40,0.9,31,102,133,60,40,9,35,77,561
178,Blake Griffin,C,33,BOS,34,14,488,58,118,0.492,20,58,0.345,38,60,0.633,0.576,16,26,0.615,37,89,126,44,12,6,16,66,152
179,Quentin Grimes,SG,22,NYK,62,57,1798,212,473,0.448,114,317,0.36,98,156,0.628,0.569,64,81,0.79,41,150,191,116,36,26,62,154,602
180,Rui Hachimura,PF,24,TOT,54,9,1288,251,518,0.485,49,143,0.343,202,375,0.539,0.532,79,106,0.745,43,194,237,49,17,21,48,59,630
180,Rui Hachimura,PF,24,WAS,30,0,728,158,324,0.488,30,89,0.337,128,235,0.545,0.534,44,58,0.759,19,109,128,35,11,12,36,39,390
180,Rui Hachimura,PF,24,LAL,24,9,560,93,194,0.479,19,54,0.352,74,140,0.529,0.528,35,48,0.729,24,85,109,14,6,9,12,20,240
181,Tyrese Haliburton,PG,22,IND,54,54,1822,398,815,0.488,158,392,0.403,240,423,0.567,0.585,167,192,0.87,32,166,198,563,89,24,135,66,1121
182,Jordan Hall,SF,21,SAS,9,0,83,9,28,0.321,3,15,0.2,6,13,0.462,0.375,7,9,0.778,3,9,12,11,1,0,7,6,28
183,R.J. Hampton,PG,21,TOT,37,1,555,74,170,0.435,29,79,0.367,45,91,0.495,0.521,45,56,0.804,15,49,64,46,23,5,32,32,222
183,R.J. Hampton,PG,21,ORL,26,0,361,50,114,0.439,18,53,0.34,32,61,0.525,0.518,31,37,0.838,9,30,39,34,16,4,21,22,149
183,R.J. Hampton,PG,21,DET,11,1,194,24,56,0.429,11,26,0.423,13,30,0.433,0.527,14,19,0.737,6,19,25,12,7,1,11,10,73
184,Tim Hardaway Jr.,SG,30,DAL,65,40,1960,303,775,0.391,190,505,0.376,113,270,0.419,0.514,113,148,0.764,21,210,231,113,48,10,55,105,909
185,James Harden,PG,33,PHI,53,53,1958,342,776,0.441,149,388,0.384,193,388,0.497,0.537,300,346,0.867,36,300,336,575,64,28,179,102,1133
186,Jaden Hardy,SG,20,DAL,38,3,529,104,246,0.423,43,115,0.374,61,131,0.466,0.51,60,71,0.845,6,56,62,43,12,4,36,50,311
187,Ron Harper Jr.,SF,22,TOR,4,0,14,4,7,0.571,2,4,0.5,2,3,0.667,0.714,0,0,,1,1,2,0,0,0,0,0,10
188,Montrezl Harrell,C,29,PHI,51,7,626,112,186,0.602,0,2,0,112,184,0.609,0.602,59,85,0.694,60,80,140,31,16,25,31,74,283
189,Gary Harris,SG,28,ORL,41,35,1026,119,264,0.451,79,184,0.429,40,80,0.5,0.6,25,28,0.893,19,65,84,50,40,8,27,80,342
190,Joe Harris,SG,31,BRK,64,33,1376,178,391,0.455,121,287,0.422,57,104,0.548,0.61,15,24,0.625,21,124,145,90,31,13,39,136,492
191,Kevon Harris,SG,25,ORL,30,0,367,34,83,0.41,11,30,0.367,23,53,0.434,0.476,22,27,0.815,24,33,57,13,16,3,16,42,101
192,Tobias Harris,PF,30,PHI,66,66,2183,384,771,0.498,115,296,0.389,269,475,0.566,0.573,95,109,0.872,63,321,384,161,65,38,81,134,978
193,Josh Hart,SF-SG,27,TOT,67,51,2190,246,467,0.527,54,148,0.365,192,319,0.602,0.585,119,160,0.744,127,402,529,263,76,15,104,176,665
193,Josh Hart,SF,27,POR,51,51,1704,183,363,0.504,34,112,0.304,149,251,0.594,0.551,87,119,0.731,95,322,417,200,54,9,79,133,487
193,Josh Hart,SG,27,NYK,16,0,486,63,104,0.606,20,36,0.556,43,68,0.632,0.702,32,41,0.78,32,80,112,63,22,6,25,43,178
194,Isaiah Hartenstein,C,24,NYK,73,7,1432,151,292,0.517,8,36,0.222,143,256,0.559,0.531,44,59,0.746,198,289,487,73,43,55,58,188,354
195,Udonis Haslem,C,42,MIA,6,1,46,1,12,0.083,0,2,0,1,10,0.1,0.083,1,2,0.5,4,4,8,0,1,1,0,8,3
196,Sam Hauser,PF,25,BOS,70,4,1096,150,334,0.449,117,282,0.415,33,52,0.635,0.624,12,17,0.706,33,142,175,52,23,19,24,91,429
197,Jaxson Hayes,C,22,NOP,43,2,596,85,150,0.567,3,27,0.111,82,123,0.667,0.577,58,83,0.699,38,90,128,34,20,19,30,67,231
198,Killian Hayes,PG,21,DET,66,46,1804,257,688,0.374,69,244,0.283,188,444,0.423,0.424,56,71,0.789,21,160,181,407,92,24,146,191,639
199,Gordon Hayward,SF,32,CHO,47,47,1482,254,540,0.47,49,152,0.322,205,388,0.528,0.516,117,146,0.801,32,171,203,187,41,12,93,68,674
200,Juancho Hernang?mez,PF,27,TOR,42,10,614,48,114,0.421,17,67,0.254,31,47,0.66,0.496,9,16,0.563,27,96,123,25,16,6,15,43,122
201,Willy Hernang?mez,C,28,NOP,34,2,441,83,159,0.522,2,10,0.2,81,149,0.544,0.528,81,103,0.786,57,114,171,32,14,13,38,61,249
202,Tyler Herro,SG,23,MIA,59,59,2085,430,991,0.434,179,478,0.374,251,513,0.489,0.524,153,165,0.927,26,308,334,253,46,16,147,96,1192
203,Buddy Hield,SF,30,IND,72,72,2283,438,958,0.457,265,624,0.425,173,334,0.518,0.596,93,113,0.823,62,298,360,195,84,22,126,142,1234
204,Haywood Highsmith,SF,26,MIA,48,9,877,85,196,0.434,36,102,0.353,49,94,0.521,0.526,12,26,0.462,50,119,169,34,34,15,35,72,218
205,George Hill,PG,36,TOT,41,1,767,70,153,0.458,28,86,0.326,42,67,0.627,0.549,36,48,0.75,14,65,79,99,23,6,32,48,204
205,George Hill,PG,36,MIL,35,0,668,59,132,0.447,23,74,0.311,36,58,0.621,0.534,34,46,0.739,13,54,67,89,19,3,27,41,175
205,George Hill,PG,36,IND,6,1,99,11,21,0.524,5,12,0.417,6,9,0.667,0.643,2,2,1,1,11,12,10,4,3,5,7,29
206,Malcolm Hill,SF,27,CHI,5,0,9,2,4,0.5,1,3,0.333,1,1,1,0.625,0,0,,0,3,3,0,0,0,0,1,5
207,Aaron Holiday,PG,26,ATL,54,5,732,79,189,0.418,31,75,0.413,48,114,0.421,0.5,24,28,0.857,21,45,66,66,27,10,30,68,213
208,Jrue Holiday,PG,32,MIL,59,57,1948,429,910,0.471,140,371,0.377,289,539,0.536,0.548,137,159,0.862,68,232,300,431,69,24,173,106,1135
209,Justin Holiday,SG,33,TOT,39,2,605,67,171,0.392,43,122,0.352,24,49,0.49,0.518,0,2,0,4,38,42,36,16,18,20,56,177
209,Justin Holiday,SG,33,ATL,28,0,411,48,125,0.384,30,87,0.345,18,38,0.474,0.504,0,0,,2,21,23,25,5,10,12,37,126
209,Justin Holiday,SG,33,DAL,11,2,194,19,46,0.413,13,35,0.371,6,11,0.545,0.554,0,2,0,2,17,19,11,11,8,8,19,51
210,Richaun Holmes,C,29,SAC,35,1,305,47,69,0.681,3,4,0.75,44,65,0.677,0.703,14,17,0.824,24,47,71,5,3,11,13,46,111
211,Al Horford,C,36,BOS,56,56,1734,205,422,0.486,127,278,0.457,78,144,0.542,0.636,15,21,0.714,66,280,346,166,27,52,31,108,552
212,Talen Horton-Tucker,SG,22,UTA,57,12,1066,195,467,0.418,45,160,0.281,150,307,0.489,0.466,90,117,0.769,28,143,171,192,36,27,103,94,525
213,Danuel House Jr.,SF,29,PHI,47,4,667,70,144,0.486,31,87,0.356,39,57,0.684,0.594,31,44,0.705,8,71,79,34,10,9,22,56,202
214,Caleb Houstan,SF,20,ORL,42,2,632,53,136,0.39,36,98,0.367,17,38,0.447,0.522,11,13,0.846,28,58,86,19,8,3,13,57,153
215,Trevor Hudgins,PG,23,HOU,5,0,28,2,9,0.222,2,8,0.25,0,1,0,0.333,3,3,1,0,0,0,3,0,0,1,1,9
216,Kevin Huerter,SG,24,SAC,66,66,1952,363,746,0.487,180,441,0.408,183,305,0.6,0.607,84,118,0.712,37,175,212,193,70,19,88,160,990
217,Jay Huff,C,24,WAS,2,0,9,1,1,1,0,0,,1,1,1,1,3,3,1,0,3,3,0,0,0,2,1,5
218,De'Andre Hunter,SF,25,ATL,61,61,1950,346,747,0.463,93,261,0.356,253,486,0.521,0.525,164,200,0.82,40,216,256,87,31,17,77,180,949
219,Bones Hyland,PG,22,TOT,47,1,891,184,471,0.391,96,259,0.371,88,212,0.415,0.493,79,92,0.859,16,88,104,133,31,13,70,82,543
219,Bones Hyland,PG,22,DEN,42,1,820,173,434,0.399,91,241,0.378,82,193,0.425,0.503,71,82,0.866,10,76,86,125,28,13,67,66,508
219,Bones Hyland,PG,22,LAC,5,0,71,11,37,0.297,5,18,0.278,6,19,0.316,0.365,8,10,0.8,6,12,18,8,3,0,3,16,35
220,Serge Ibaka,C,33,MIL,16,0,185,26,54,0.481,6,18,0.333,20,36,0.556,0.537,8,13,0.615,15,29,44,4,2,7,11,23,66
221,Andre Iguodala,SF,39,GSW,8,0,113,7,15,0.467,1,9,0.111,6,6,1,0.5,2,3,0.667,3,14,17,19,4,3,9,11,17
222,Joe Ingles,SF,35,MIL,37,0,855,90,207,0.435,67,166,0.404,23,41,0.561,0.597,16,19,0.842,12,106,118,119,25,5,45,67,263
223,Brandon Ingram,SF,25,NOP,34,34,1129,289,612,0.472,53,135,0.393,236,477,0.495,0.516,159,184,0.864,14,152,166,170,23,14,110,90,790
224,Kyrie Irving,PG,30,TOT,53,53,1966,530,1077,0.492,173,453,0.382,357,624,0.572,0.572,220,244,0.902,52,218,270,290,55,39,119,150,1453
224,Kyrie Irving,PG,30,BRK,40,40,1478,398,819,0.486,130,348,0.374,268,471,0.569,0.565,158,179,0.883,38,166,204,211,41,33,91,109,1084
224,Kyrie Irving,PG,30,DAL,13,13,488,132,258,0.512,43,105,0.41,89,153,0.582,0.595,62,65,0.954,14,52,66,79,14,6,28,41,369
225,Jonathan Isaac,PF,25,ORL,11,0,124,22,53,0.415,6,15,0.4,16,38,0.421,0.472,5,9,0.556,15,29,44,6,14,4,4,5,55
226,Jaden Ivey,SG,20,DET,64,63,1946,331,803,0.412,93,278,0.335,238,525,0.453,0.47,226,311,0.727,64,184,248,313,54,17,191,202,981
227,Frank Jackson,PG,24,UTA,1,0,5,0,3,0,0,1,0,0,2,0,0,0,0,,1,1,2,1,0,0,0,0,0
228,Isaiah Jackson,C,21,IND,53,7,818,141,247,0.571,2,12,0.167,139,235,0.591,0.575,76,117,0.65,86,134,220,44,24,78,41,118,360
229,Jaren Jackson Jr.,C,23,MEM,54,54,1512,339,683,0.496,83,243,0.342,256,440,0.582,0.557,193,248,0.778,90,265,355,48,55,165,83,191,954
230,Justin Jackson,SF,27,BOS,23,0,107,7,27,0.259,5,20,0.25,2,7,0.286,0.352,1,2,0.5,2,15,17,9,4,4,2,7,20
231,Quenton Jackson,PG,24,WAS,3,0,8,2,3,0.667,1,2,0.5,1,1,1,0.833,0,0,,1,0,1,1,0,0,0,1,5
232,Reggie Jackson,PG,32,TOT,62,38,1524,236,582,0.405,88,257,0.342,148,325,0.455,0.481,67,74,0.905,24,106,130,213,43,6,107,105,627
232,Reggie Jackson,PG,32,LAC,52,38,1338,214,512,0.418,77,220,0.35,137,292,0.469,0.493,61,66,0.924,22,94,116,183,38,5,96,92,566
232,Reggie Jackson,PG,32,DEN,10,0,186,22,70,0.314,11,37,0.297,11,33,0.333,0.393,6,8,0.75,2,12,14,30,5,1,11,13,61
233,LeBron James,PF,38,LAL,47,47,1695,532,1061,0.501,100,325,0.308,432,736,0.587,0.549,224,295,0.759,57,339,396,326,44,26,147,79,1388
234,Ty Jerome,SG,25,GSW,44,2,814,118,242,0.488,35,90,0.389,83,152,0.546,0.56,38,41,0.927,7,71,78,135,23,5,30,64,309
235,Isaiah Joe,SG,23,OKC,63,8,1141,188,412,0.456,142,328,0.433,46,84,0.548,0.629,55,67,0.821,20,127,147,73,38,7,30,89,573
236,Alize Johnson,PF,26,SAS,4,0,30,3,6,0.5,0,2,0,3,4,0.75,0.5,1,2,0.5,2,8,10,1,1,0,4,3,7
237,Cameron Johnson,PF,26,TOT,32,31,894,164,362,0.453,81,206,0.393,83,156,0.532,0.565,75,93,0.806,22,118,140,52,37,11,23,61,484
237,Cameron Johnson,PF,26,PHO,17,16,429,82,173,0.474,45,99,0.455,37,74,0.5,0.604,27,33,0.818,14,51,65,26,15,6,10,29,236
237,Cameron Johnson,PF,26,BRK,15,15,465,82,189,0.434,36,107,0.336,46,82,0.561,0.529,48,60,0.8,8,67,75,26,22,5,13,32,248
238,Jalen Johnson,SF,21,ATL,64,6,925,131,273,0.48,26,89,0.292,105,184,0.571,0.527,43,66,0.652,47,203,250,65,29,27,31,97,331
239,James Johnson,PF,35,IND,14,1,124,14,35,0.4,3,12,0.25,11,23,0.478,0.443,4,6,0.667,2,19,21,10,4,6,5,27,35
240,Keldon Johnson,SF,23,SAS,60,60,1969,475,1055,0.45,127,387,0.328,348,668,0.521,0.51,232,308,0.753,52,250,302,171,44,11,130,121,1309
241,Keon Johnson,SG,20,POR,37,0,337,52,145,0.359,22,66,0.333,30,79,0.38,0.434,17,28,0.607,9,29,38,42,15,6,34,37,143
242,Stanley Johnson,SF,26,SAS,30,0,469,65,122,0.533,18,40,0.45,47,82,0.573,0.607,26,39,0.667,22,73,95,67,16,6,33,48,174
243,Nikola Joki?,C,27,DEN,64,64,2172,607,957,0.634,54,137,0.394,553,820,0.674,0.662,315,385,0.818,156,606,762,634,79,42,227,165,1583
244,Carlik Jones,PG,25,CHI,2,0,23,1,5,0.2,0,1,0,1,4,0.25,0.2,1,4,0.25,1,2,3,2,0,0,1,1,3
245,Damian Jones,C,27,TOT,31,1,304,34,55,0.618,3,6,0.5,31,49,0.633,0.645,19,25,0.76,27,54,81,9,4,19,14,37,90
245,Damian Jones,C,27,LAL,22,1,176,20,37,0.541,0,3,0,20,34,0.588,0.541,15,20,0.75,18,37,55,4,3,12,9,17,55
245,Damian Jones,C,27,UTA,9,0,128,14,18,0.778,3,3,1,11,15,0.733,0.861,4,5,0.8,9,17,26,5,1,7,5,20,35
246,Derrick Jones Jr.,SF,25,CHI,54,0,737,94,186,0.505,19,59,0.322,75,127,0.591,0.556,56,73,0.767,50,77,127,31,22,31,22,72,263
247,Herbert Jones,SF,24,NOP,55,55,1601,194,424,0.458,43,144,0.299,151,280,0.539,0.508,105,140,0.75,79,142,221,129,91,34,72,181,536
248,Kai Jones,C,22,CHO,38,0,383,47,85,0.553,3,12,0.25,44,73,0.603,0.571,15,20,0.75,31,60,91,7,12,21,19,53,112
249,Tre Jones,PG,23,SAS,58,55,1690,280,636,0.44,36,138,0.261,244,498,0.49,0.469,127,145,0.876,45,155,200,362,76,9,96,83,723
250,Tyus Jones,PG,26,MEM,71,18,1707,280,631,0.444,107,283,0.378,173,348,0.497,0.529,73,91,0.802,25,147,172,352,73,4,67,29,740
251,DeAndre Jordan,C,34,DEN,35,5,499,75,97,0.773,1,1,1,74,96,0.771,0.778,18,41,0.439,41,127,168,31,8,22,42,65,169
252,Cory Joseph,PG,31,DET,53,2,971,117,273,0.429,48,127,0.378,69,146,0.473,0.516,50,63,0.794,14,71,85,178,28,8,47,75,332
253,Nikola Jovi?,PF,19,MIA,15,8,204,28,69,0.406,8,35,0.229,20,34,0.588,0.464,18,19,0.947,9,22,31,10,7,2,10,19,82
254,Johnny Juzang,SF,21,UTA,9,0,92,13,38,0.342,8,26,0.308,5,12,0.417,0.447,0,2,0,2,12,14,2,2,3,2,9,34
255,Mfiondu Kabengele,PF,25,BOS,2,0,14,1,2,0.5,0,1,0,1,1,1,0.5,0,0,,3,2,5,0,0,0,1,3,2
256,Frank Kaminsky,C,29,TOT,33,0,212,27,55,0.491,12,30,0.4,15,25,0.6,0.6,14,16,0.875,4,41,45,28,6,3,9,22,80
256,Frank Kaminsky,C,29,ATL,26,0,176,25,44,0.568,11,23,0.478,14,21,0.667,0.693,10,12,0.833,3,33,36,21,5,1,9,21,71
256,Frank Kaminsky,C,29,HOU,7,0,36,2,11,0.182,1,7,0.143,1,4,0.25,0.227,4,4,1,1,8,9,7,1,2,0,1,9
257,Trevor Keels,SG,19,NYK,2,0,4,1,3,0.333,1,3,0.333,0,0,,0.5,0,0,,0,2,2,0,0,0,0,0,3
258,Luke Kennard,SG,26,TOT,50,11,1055,138,300,0.46,93,202,0.46,45,98,0.459,0.615,30,32,0.938,8,112,120,68,27,4,39,71,399
258,Luke Kennard,SG,26,LAC,35,11,725,98,211,0.464,59,132,0.447,39,79,0.494,0.604,19,20,0.95,6,77,83,37,19,4,30,47,274
258,Luke Kennard,SG,26,MEM,15,0,330,40,89,0.449,34,70,0.486,6,19,0.316,0.64,11,12,0.917,2,35,37,31,8,0,9,24,125
259,Walker Kessler,C,21,UTA,67,33,1523,252,350,0.72,1,2,0.5,251,348,0.721,0.721,75,140,0.536,209,351,560,57,24,155,54,155,580
260,Braxton Key,SF,25,DET,3,0,9,1,1,1,0,0,,1,1,1,1,2,2,1,0,1,1,0,0,0,0,0,4
261,Corey Kispert,SF,23,WAS,63,34,1733,222,445,0.499,124,293,0.423,98,152,0.645,0.638,57,65,0.877,28,144,172,74,31,7,44,79,625
262,Maxi Kleber,C,31,DAL,30,3,774,64,137,0.467,31,88,0.352,33,49,0.673,0.58,21,32,0.656,25,91,116,40,9,27,20,68,180
263,Nathan Knight,PF,25,MIN,36,0,284,44,78,0.564,8,22,0.364,36,56,0.643,0.615,38,55,0.691,21,33,54,13,9,6,19,37,134
264,Kevin Knox,PF-SF,23,TOT,52,1,648,93,195,0.477,46,124,0.371,47,71,0.662,0.595,28,35,0.8,23,97,120,17,16,12,32,81,260
264,Kevin Knox,PF,23,DET,42,1,593,84,179,0.469,43,116,0.371,41,63,0.651,0.589,26,33,0.788,20,88,108,15,14,12,32,74,237
264,Kevin Knox,SF,23,POR,10,0,55,9,16,0.563,3,8,0.375,6,8,0.75,0.656,2,2,1,3,9,12,2,2,0,0,7,23
265,Christian Koloko,C,22,TOR,49,19,685,61,128,0.477,1,9,0.111,60,119,0.504,0.48,35,53,0.66,72,78,150,23,14,49,18,114,158
266,John Konchar,SG,26,MEM,63,22,1331,123,286,0.43,58,162,0.358,65,124,0.524,0.531,27,33,0.818,54,218,272,85,64,18,33,99,331
267,Furkan Korkmaz,SG,25,PHI,29,0,273,35,85,0.412,13,37,0.351,22,48,0.458,0.488,20,30,0.667,6,24,30,19,6,3,19,10,103
268,Luke Kornet,C,27,BOS,59,0,694,97,142,0.683,3,10,0.3,94,132,0.712,0.694,30,37,0.811,78,95,173,41,10,43,24,74,227
269,Vit Krejci,PG,22,ATL,23,0,124,11,29,0.379,5,18,0.278,6,11,0.545,0.466,1,2,0.5,2,12,14,12,3,1,4,11,28
270,Jonathan Kuminga,PF,20,GSW,58,13,1189,219,430,0.509,45,127,0.354,174,303,0.574,0.562,74,112,0.661,58,138,196,108,33,27,88,138,557
271,Kyle Kuzma,PF,27,WAS,64,64,2239,512,1142,0.448,160,481,0.333,352,661,0.533,0.518,173,237,0.73,55,408,463,239,36,29,190,145,1357
272,Anthony Lamb,SF,25,GSW,53,3,1062,134,281,0.477,69,183,0.377,65,98,0.663,0.6,40,53,0.755,47,136,183,88,26,17,48,122,377
273,Jock Landale,C,27,PHO,62,3,861,151,291,0.519,20,81,0.247,131,210,0.624,0.553,77,100,0.77,105,142,247,57,15,29,54,113,399
274,Romeo Langford,SG,23,SAS,36,20,727,110,224,0.491,14,50,0.28,96,174,0.552,0.522,32,47,0.681,51,50,101,44,18,13,23,60,266
275,Jake LaRavia,PF,21,MEM,33,0,391,35,91,0.385,22,67,0.328,13,24,0.542,0.505,7,9,0.778,17,43,60,21,12,4,18,48,99
276,Zach LaVine,SG,27,CHI,67,67,2439,584,1216,0.48,187,490,0.382,397,726,0.547,0.557,323,380,0.85,38,277,315,275,63,16,171,143,1678
277,A.J. Lawson,SG,22,TOT,13,0,63,13,26,0.5,7,16,0.438,6,10,0.6,0.635,1,3,0.333,2,8,10,1,1,0,1,8,34
277,A.J. Lawson,SG,22,MIN,1,0,2,1,1,1,0,0,,1,1,1,1,0,0,,0,1,1,0,0,0,0,1,2
277,A.J. Lawson,SG,22,DAL,12,0,61,12,25,0.48,7,16,0.438,5,9,0.556,0.62,1,3,0.333,2,7,9,1,1,0,1,7,32
278,Damion Lee,SG,30,PHO,70,5,1450,192,432,0.444,107,240,0.446,85,192,0.443,0.568,92,102,0.902,35,180,215,98,30,7,74,114,583
279,Saben Lee,PG,23,TOT,22,0,302,37,88,0.42,7,20,0.35,30,68,0.441,0.46,36,47,0.766,11,26,37,55,15,1,23,27,117
279,Saben Lee,PG,23,PHI,2,0,10,3,4,0.75,0,1,0,3,3,1,0.75,0,0,,0,0,0,2,1,0,3,1,6
279,Saben Lee,PG,23,PHO,20,0,292,34,84,0.405,7,19,0.368,27,65,0.415,0.446,36,47,0.766,11,26,37,53,14,1,20,26,111
280,Alex Len,C,29,SAC,18,1,58,5,12,0.417,0,2,0,5,10,0.5,0.417,3,4,0.75,4,13,17,6,0,0,9,12,13
281,Kawhi Leonard,SF,31,LAC,43,41,1447,368,719,0.512,83,200,0.415,285,519,0.549,0.57,204,232,0.879,50,222,272,165,62,23,69,68,1023
282,Meyers Leonard,C,30,MIL,6,0,51,8,14,0.571,5,10,0.5,3,4,0.75,0.75,3,4,0.75,2,11,13,0,1,0,2,7,24
283,Caris LeVert,SG,28,CLE,67,28,2013,287,680,0.422,108,287,0.376,179,393,0.455,0.501,117,162,0.722,51,211,262,266,64,20,107,149,799
284,Kira Lewis Jr.,PG,21,NOP,21,0,219,37,83,0.446,13,30,0.433,24,53,0.453,0.524,17,20,0.85,5,28,33,18,9,2,10,24,104
285,Damian Lillard,PG,32,POR,57,57,2073,548,1183,0.463,242,648,0.373,306,535,0.572,0.566,498,544,0.915,43,227,270,413,50,18,189,108,1836
286,Nassir Little,SF,22,POR,49,2,856,112,246,0.455,52,134,0.388,60,112,0.536,0.561,27,39,0.692,23,105,128,47,17,18,29,58,303
287,Isaiah Livers,PF,24,DET,46,16,1030,101,248,0.407,63,179,0.352,38,69,0.551,0.534,23,30,0.767,23,93,116,34,27,25,26,88,288
288,Kenneth Lofton Jr.,PF,20,MEM,16,0,72,19,40,0.475,4,11,0.364,15,29,0.517,0.525,5,9,0.556,8,11,19,11,1,1,5,13,47
289,Kevon Looney,C,26,GSW,73,64,1720,223,347,0.643,0,1,0,223,346,0.645,0.643,82,138,0.594,238,427,665,177,45,46,40,204,528
290,Brook Lopez,C,34,MIL,69,69,2118,414,795,0.521,128,339,0.378,286,456,0.627,0.601,122,159,0.767,136,326,462,91,35,172,97,175,1078
291,Robin Lopez,C,34,CLE,34,1,254,39,60,0.65,2,3,0.667,37,57,0.649,0.667,12,16,0.75,21,24,45,14,1,6,22,34,92
292,Kevin Love,PF,34,TOT,54,16,1097,145,373,0.389,87,259,0.336,58,114,0.509,0.505,73,83,0.88,55,308,363,100,12,10,64,85,450
292,Kevin Love,PF,34,CLE,41,3,821,111,285,0.389,69,195,0.354,42,90,0.467,0.511,56,63,0.889,42,238,280,76,7,7,47,65,347
292,Kevin Love,PF,34,MIA,13,13,276,34,88,0.386,18,64,0.281,16,24,0.667,0.489,17,20,0.85,13,70,83,24,5,3,17,20,103
293,Kyle Lowry,PG,36,MIA,48,44,1565,181,447,0.405,99,285,0.347,82,162,0.506,0.516,103,121,0.851,38,165,203,250,51,18,94,132,564
294,Trey Lyles,PF,27,SAC,63,0,1063,167,348,0.48,76,201,0.378,91,147,0.619,0.589,88,110,0.8,57,192,249,61,22,27,54,81,498
295,Th?o Maledon,PG,21,CHO,36,1,581,65,157,0.414,21,63,0.333,44,94,0.468,0.481,49,56,0.875,9,77,86,86,27,6,35,37,200
296,Sandro Mamukelashvili,C,23,TOT,32,1,375,38,110,0.345,17,58,0.293,21,52,0.404,0.423,23,35,0.657,40,67,107,30,6,7,16,38,116
296,Sandro Mamukelashvili,C,23,MIL,24,0,217,19,58,0.328,7,32,0.219,12,26,0.462,0.388,12,18,0.667,18,38,56,16,4,5,9,19,57
296,Sandro Mamukelashvili,C,23,SAS,8,1,158,19,52,0.365,10,26,0.385,9,26,0.346,0.462,11,17,0.647,22,29,51,14,2,2,7,19,59
297,Terance Mann,SG,26,LAC,71,35,1647,246,466,0.528,65,169,0.385,181,297,0.609,0.598,79,101,0.782,69,180,249,162,37,20,67,129,636
298,Tre Mann,PG,21,OKC,60,4,1082,179,461,0.388,76,240,0.317,103,221,0.466,0.471,37,50,0.74,24,112,136,102,36,11,55,89,471
299,Boban Marjanovi?,C,34,HOU,25,0,119,31,45,0.689,0,1,0,31,44,0.705,0.689,18,24,0.75,13,29,42,5,4,1,8,5,80
300,Lauri Markkanen,SF,25,UTA,63,63,2169,543,1079,0.503,193,481,0.401,350,598,0.585,0.593,324,372,0.871,124,416,540,116,40,38,120,131,1603
301,Naji Marshall,SF,25,NOP,66,21,1622,219,508,0.431,63,204,0.309,156,304,0.513,0.493,124,155,0.8,43,205,248,166,49,13,83,98,625
302,Caleb Martin,PF,27,MIA,62,49,1845,232,496,0.468,82,219,0.374,150,277,0.542,0.55,82,102,0.804,79,224,303,101,62,29,68,127,628
303,Cody Martin,SF,27,CHO,7,0,134,14,36,0.389,3,14,0.214,11,22,0.5,0.431,4,7,0.571,8,16,24,11,4,1,2,13,35
304,Kenyon Martin Jr.,SF,22,HOU,72,39,1975,350,620,0.565,60,194,0.309,290,426,0.681,0.613,128,189,0.677,110,291,401,109,38,25,84,127,888
305,Tyrese Martin,SG,23,ATL,13,0,45,6,16,0.375,1,5,0.2,5,11,0.455,0.406,2,2,1,2,4,6,0,1,0,1,2,15
306,Garrison Mathews,SG,26,TOT,48,0,610,61,172,0.355,54,157,0.344,7,15,0.467,0.512,43,48,0.896,10,53,63,23,23,4,18,56,219
306,Garrison Mathews,SG,26,HOU,45,0,602,60,170,0.353,53,155,0.342,7,15,0.467,0.509,41,45,0.911,10,52,62,23,23,4,18,56,214
306,Garrison Mathews,SG,26,ATL,3,0,8,1,2,0.5,1,2,0.5,0,0,,0.75,2,3,0.667,0,1,1,0,0,0,0,0,5
307,Bennedict Mathurin,SF,20,IND,68,7,1890,361,838,0.431,89,280,0.318,272,558,0.487,0.484,322,390,0.826,74,198,272,96,41,8,122,138,1133
308,Wesley Matthews,SG,36,MIL,41,0,632,43,125,0.344,33,100,0.33,10,25,0.4,0.476,17,20,0.85,30,59,89,21,17,10,16,59,136
309,Tyrese Maxey,SG,22,PHI,52,33,1724,376,794,0.474,130,312,0.417,246,482,0.51,0.555,159,189,0.841,22,122,144,182,40,7,70,114,1041
310,Miles McBride,PG,22,NYK,56,2,674,67,186,0.36,37,119,0.311,30,67,0.448,0.46,26,38,0.684,13,34,47,63,33,7,21,52,197
311,CJ McCollum,SG,31,NOP,64,64,2251,503,1157,0.435,181,472,0.383,322,685,0.47,0.513,162,207,0.783,52,230,282,381,57,34,165,128,1349
312,T.J. McConnell,PG,30,IND,67,6,1343,231,437,0.529,23,52,0.442,208,385,0.54,0.555,49,58,0.845,40,164,204,348,74,7,123,90,534
313,Jaden McDaniels,SF,22,MIN,70,70,2157,327,631,0.518,95,240,0.396,232,391,0.593,0.594,96,128,0.75,86,189,275,137,64,68,100,243,845
314,Jalen McDaniels,SF,25,TOT,71,22,1725,252,557,0.452,68,214,0.318,184,343,0.536,0.513,109,131,0.832,57,262,319,120,72,29,87,194,681
314,Jalen McDaniels,SF,25,CHO,56,21,1494,221,494,0.447,65,202,0.322,156,292,0.534,0.513,88,104,0.846,44,226,270,111,66,29,80,158,595
314,Jalen McDaniels,SF,25,PHI,15,1,231,31,63,0.492,3,12,0.25,28,51,0.549,0.516,21,27,0.778,13,36,49,9,6,0,7,36,86
315,Doug McDermott,SF,31,SAS,59,0,1220,219,472,0.464,114,267,0.427,105,205,0.512,0.585,40,56,0.714,18,111,129,87,12,6,57,105,592
316,JaVale McGee,C,35,DAL,37,7,296,65,107,0.607,1,4,0.25,64,103,0.621,0.612,20,34,0.588,28,66,94,10,4,21,32,46,151
317,Bryce McGowens,SG,20,CHO,37,1,537,45,123,0.366,14,46,0.304,31,77,0.403,0.423,34,43,0.791,14,47,61,29,9,5,25,33,138
318,Rodney McGruder,SG,31,DET,31,11,496,60,145,0.414,40,93,0.43,20,52,0.385,0.552,16,20,0.8,19,51,70,28,14,1,11,35,176
319,Jordan McLaughlin,PG,26,MIN,36,0,572,55,129,0.426,18,68,0.265,37,61,0.607,0.496,11,14,0.786,15,39,54,117,31,3,28,21,139
320,De'Anthony Melton,PG,24,PHI,68,52,1903,249,576,0.432,145,361,0.402,104,215,0.484,0.558,56,70,0.8,59,224,283,179,114,38,89,168,699
321,Sam Merrill,SG,26,CLE,2,0,8,1,3,0.333,0,2,0,1,1,1,0.333,0,0,,0,0,0,0,0,0,0,1,2
322,Chimezie Metu,C,25,SAC,58,0,631,117,196,0.597,9,36,0.25,108,160,0.675,0.62,43,57,0.754,44,134,178,40,20,21,29,77,286
323,Khris Middleton,SF,31,MIL,27,13,649,139,324,0.429,44,131,0.336,95,193,0.492,0.497,77,86,0.895,23,89,112,130,20,5,58,61,399
324,Patty Mills,PG,34,BRK,38,1,515,81,193,0.42,47,123,0.382,34,70,0.486,0.541,21,23,0.913,8,34,42,52,14,3,26,27,230
325,Shake Milton,SG,26,PHI,67,9,1355,214,431,0.497,52,130,0.4,162,301,0.538,0.557,87,103,0.845,31,136,167,188,22,11,77,102,567
326,Josh Minott,SF,20,MIN,14,0,92,18,34,0.529,2,6,0.333,16,28,0.571,0.559,8,8,1,5,20,25,4,4,6,3,10,46
327,Davion Mitchell,PG,24,SAC,70,7,1248,156,342,0.456,55,166,0.331,101,176,0.574,0.537,22,28,0.786,14,78,92,152,34,13,56,97,389
328,Donovan Mitchell,SG,26,CLE,61,61,2165,590,1236,0.477,214,569,0.376,376,667,0.564,0.564,275,314,0.876,58,195,253,281,93,23,161,148,1669
329,Evan Mobley,PF,21,CLE,71,71,2432,467,850,0.549,20,95,0.211,447,755,0.592,0.561,193,283,0.682,166,468,634,194,55,100,139,203,1147
330,Isaiah Mobley,PF,23,CLE,10,0,30,5,10,0.5,1,3,0.333,4,7,0.571,0.55,0,0,,1,11,12,0,1,1,0,2,11
331,Chima Moneke,SF,27,SAC,2,0,8,1,2,0.5,0,0,,1,2,0.5,0.5,0,2,0,2,0,2,1,0,0,2,2,2
332,Malik Monk,SG,24,SAC,68,0,1536,320,711,0.45,127,354,0.359,193,357,0.541,0.539,167,189,0.884,31,151,182,268,42,17,134,113,934
333,Moses Moody,SG,20,GSW,56,3,733,88,197,0.447,41,120,0.342,47,77,0.61,0.551,36,52,0.692,26,65,91,46,18,6,31,43,253
334,Wendell Moore Jr.,SG,21,MIN,27,2,149,17,42,0.405,2,17,0.118,15,25,0.6,0.429,4,5,0.8,3,14,17,18,8,5,8,13,40
335,Ja Morant,PG,23,MEM,53,53,1721,507,1094,0.463,85,269,0.316,422,825,0.512,0.502,337,453,0.744,60,257,317,434,59,13,180,88,1436
336,Marcus Morris,PF,33,LAC,62,62,1748,267,620,0.431,111,297,0.374,156,323,0.483,0.52,68,87,0.782,27,220,247,107,41,21,54,134,713
337,Markieff Morris,PF,33,TOT,32,1,309,37,89,0.416,22,54,0.407,15,35,0.429,0.539,10,10,1,13,49,62,26,9,5,17,38,106
337,Markieff Morris,PF,33,BRK,27,1,285,33,82,0.402,20,49,0.408,13,33,0.394,0.524,10,10,1,13,46,59,25,8,5,14,33,96
337,Markieff Morris,PF,33,DAL,5,0,24,4,7,0.571,2,5,0.4,2,2,1,0.714,0,0,,0,3,3,1,1,0,3,5,10
338,Monte Morris,PG,27,WAS,57,56,1579,223,467,0.478,74,186,0.398,149,281,0.53,0.557,61,74,0.824,23,175,198,295,39,10,58,75,581
339,Trey Murphy III,SF,22,NOP,68,54,2042,312,657,0.475,161,405,0.398,151,252,0.599,0.597,126,139,0.906,55,197,252,94,70,36,54,133,911
340,Dejounte Murray,SG,26,ATL,66,66,2403,546,1188,0.46,126,358,0.352,420,830,0.506,0.513,134,162,0.827,48,310,358,398,101,18,145,96,1352
341,Jamal Murray,PG,25,DEN,58,58,1916,425,944,0.45,150,381,0.394,275,563,0.488,0.53,167,202,0.827,44,185,229,352,60,12,128,87,1167
342,Keegan Murray,SF,22,SAC,69,67,2041,293,659,0.445,172,423,0.407,121,236,0.513,0.575,59,76,0.776,75,243,318,79,55,37,55,132,817
343,Mike Muscala,C,31,TOT,53,7,796,111,253,0.439,70,180,0.389,41,73,0.562,0.577,32,41,0.78,27,142,169,41,15,22,19,86,324
343,Mike Muscala,C,31,OKC,43,5,622,89,203,0.438,56,142,0.394,33,61,0.541,0.576,31,39,0.795,23,112,135,38,11,19,14,70,265
343,Mike Muscala,C,31,BOS,10,2,174,22,50,0.44,14,38,0.368,8,12,0.667,0.58,1,2,0.5,4,30,34,3,4,3,5,16,59
344,Svi Mykhailiuk,SF,25,TOT,23,0,165,23,53,0.434,16,31,0.516,7,22,0.318,0.585,7,15,0.467,3,14,17,10,3,1,6,6,69
344,Svi Mykhailiuk,SF,25,NYK,13,0,40,6,12,0.5,6,10,0.6,0,2,0,0.75,3,5,0.6,0,7,7,1,1,0,2,1,21
344,Svi Mykhailiuk,SF,25,CHO,10,0,125,17,41,0.415,10,21,0.476,7,20,0.35,0.537,4,10,0.4,3,7,10,9,2,1,4,5,48
345,Larry Nance Jr.,PF,30,NOP,54,1,1170,168,272,0.618,14,39,0.359,154,233,0.661,0.643,48,71,0.676,94,212,306,100,48,34,37,113,398
346,Andrew Nembhard,SG,23,IND,65,53,1761,221,519,0.426,79,231,0.342,142,288,0.493,0.502,39,49,0.796,30,141,171,262,60,12,103,157,560
347,Aaron Nesmith,SF,23,IND,63,51,1559,217,508,0.427,97,273,0.355,120,235,0.511,0.523,99,116,0.853,54,186,240,80,48,28,64,208,630
348,Raul Neto,PG,30,CLE,45,1,450,50,94,0.532,12,37,0.324,38,57,0.667,0.596,24,27,0.889,7,33,40,63,16,3,16,40,136
349,Georges Niang,PF,29,PHI,68,0,1306,195,441,0.442,137,340,0.403,58,101,0.574,0.598,32,38,0.842,18,142,160,70,26,12,45,129,559
350,Daishen Nix,PG,20,HOU,48,7,801,74,206,0.359,37,119,0.311,37,87,0.425,0.449,23,34,0.676,16,70,86,122,29,6,72,53,208
351,Zeke Nnaji,PF,22,DEN,45,5,595,89,154,0.578,13,45,0.289,76,109,0.697,0.62,36,54,0.667,56,51,107,12,15,20,21,83,227
352,Nerlens Noel,C,28,TOT,17,4,195,13,36,0.361,1,2,0.5,12,34,0.353,0.375,8,12,0.667,10,36,46,10,16,10,13,32,35
352,Nerlens Noel,C,28,DET,14,3,152,12,30,0.4,1,2,0.5,11,28,0.393,0.417,7,10,0.7,7,30,37,7,13,9,8,25,32
352,Nerlens Noel,C,28,BRK,3,1,43,1,6,0.167,0,0,,1,6,0.167,0.167,1,2,0.5,3,6,9,3,3,1,5,7,3
353,Jaylen Nowell,SG,23,MIN,63,2,1228,274,612,0.448,66,227,0.291,208,385,0.54,0.502,76,97,0.784,34,131,165,130,42,5,63,97,690
354,Frank Ntilikina,PG,24,DAL,43,3,496,37,104,0.356,13,55,0.236,24,49,0.49,0.418,16,24,0.667,6,49,55,47,11,4,25,54,103
355,Kendrick Nunn,SG-PG,27,TOT,60,2,811,151,361,0.418,60,179,0.335,91,182,0.5,0.501,28,33,0.848,12,76,88,69,21,3,52,52,390
355,Kendrick Nunn,SG,27,LAL,39,2,528,102,251,0.406,41,126,0.325,61,125,0.488,0.488,17,21,0.81,5,50,55,34,11,3,31,35,262
355,Kendrick Nunn,PG,27,WAS,21,0,283,49,110,0.445,19,53,0.358,30,57,0.526,0.532,11,12,0.917,7,26,33,35,10,0,21,17,128
356,Jusuf Nurki?,C,28,POR,51,51,1360,255,493,0.517,41,114,0.36,214,379,0.565,0.559,123,186,0.661,114,353,467,145,42,43,119,182,674
357,Jordan Nwora,SF,24,TOT,52,7,914,139,330,0.421,65,159,0.409,74,171,0.433,0.52,50,64,0.781,42,139,181,71,23,11,53,55,393
357,Jordan Nwora,SF,24,MIL,38,3,597,76,197,0.386,40,102,0.392,36,95,0.379,0.487,37,43,0.86,29,88,117,38,12,7,34,34,229
357,Jordan Nwora,SF,24,IND,14,4,317,63,133,0.474,25,57,0.439,38,76,0.5,0.568,13,21,0.619,13,51,64,33,11,4,19,21,164
358,Royce O'Neale,SF,29,BRK,67,52,2152,202,521,0.388,144,365,0.395,58,156,0.372,0.526,45,61,0.738,50,285,335,249,59,42,98,211,593
359,Chuma Okeke,SF,24,ORL,22,7,413,34,93,0.366,20,65,0.308,14,28,0.5,0.473,16,21,0.762,21,57,78,26,12,9,11,35,104
360,Josh Okogie,SG,24,PHO,61,15,1074,138,343,0.402,54,163,0.331,84,180,0.467,0.481,111,152,0.73,93,111,204,81,48,28,57,95,441
361,Onyeka Okongwu,C,22,ATL,69,17,1622,270,423,0.638,2,7,0.286,268,416,0.644,0.641,119,158,0.753,186,313,499,70,49,86,69,220,661
362,Isaac Okoro,SF,22,CLE,73,43,1593,170,344,0.494,59,165,0.358,111,179,0.62,0.58,76,101,0.752,52,130,182,84,55,30,41,150,475
363,KZ Okpala,PF,23,SAC,35,3,248,16,38,0.421,7,21,0.333,9,17,0.529,0.513,7,8,0.875,7,27,34,13,7,7,7,39,46
364,Victor Oladipo,SG,30,MIA,38,1,1015,137,350,0.391,56,178,0.315,81,172,0.471,0.471,54,71,0.761,16,105,121,129,52,11,74,89,384
365,Kelly Olynyk,C,31,UTA,59,59,1668,234,472,0.496,83,208,0.399,151,264,0.572,0.584,164,194,0.845,73,266,339,203,53,34,134,207,715
366,Eugene Omoruyi,SF,25,TOT,32,5,461,77,165,0.467,14,55,0.255,63,110,0.573,0.509,29,43,0.674,35,44,79,19,21,1,21,74,197
366,Eugene Omoruyi,SF,25,OKC,23,2,272,44,94,0.468,8,31,0.258,36,63,0.571,0.511,17,28,0.607,22,30,52,11,14,0,16,46,113
366,Eugene Omoruyi,SF,25,DET,9,3,189,33,71,0.465,6,24,0.25,27,47,0.574,0.507,12,15,0.8,13,14,27,8,7,1,5,28,84
367,Cedi Osman,SF,27,CLE,68,0,1402,216,478,0.452,100,278,0.36,116,200,0.58,0.556,66,96,0.688,23,133,156,103,33,8,47,108,598
368,Kelly Oubre Jr.,SF,27,CHO,47,39,1535,349,809,0.431,108,336,0.321,241,473,0.51,0.498,158,207,0.763,65,181,246,52,66,18,63,140,964
369,Chris Paul,PG,37,PHO,50,50,1604,241,558,0.432,77,213,0.362,164,345,0.475,0.501,118,144,0.819,19,194,213,458,81,19,100,108,677
370,Cameron Payne,PG,28,PHO,39,14,836,162,389,0.416,61,165,0.37,101,224,0.451,0.495,43,57,0.754,12,79,91,183,30,6,74,73,428
371,Gary Payton II,PG,30,POR,15,1,255,24,41,0.585,9,17,0.529,15,24,0.625,0.695,4,4,1,10,29,39,22,16,1,12,29,61
372,Theo Pinson,SG,27,DAL,37,0,245,20,61,0.328,15,44,0.341,5,17,0.294,0.451,9,11,0.818,8,33,41,30,4,1,9,24,64
373,Scotty Pippen Jr.,PG,22,LAL,6,0,32,4,12,0.333,1,3,0.333,3,9,0.333,0.375,5,9,0.556,2,2,4,2,2,1,2,3,14
374,Mason Plumlee,C,32,TOT,69,60,1862,301,446,0.675,0,0,,301,446,0.675,0.675,192,304,0.632,212,435,647,228,43,41,105,195,794
374,Mason Plumlee,C,32,CHO,56,56,1597,265,396,0.669,0,0,,265,396,0.669,0.669,155,256,0.605,187,354,541,205,35,35,87,161,685
374,Mason Plumlee,C,32,LAC,13,4,265,36,50,0.72,0,0,,36,50,0.72,0.72,37,48,0.771,25,81,106,23,8,6,18,34,109
375,Jakob Poeltl,C,27,TOT,62,61,1653,343,544,0.631,0,1,0,343,543,0.632,0.631,111,182,0.61,203,363,566,182,58,77,114,171,797
375,Jakob Poeltl,C,27,SAS,46,46,1199,239,388,0.616,0,1,0,239,387,0.618,0.616,78,129,0.605,152,264,416,141,36,52,96,118,556
375,Jakob Poeltl,C,27,TOR,16,15,454,104,156,0.667,0,0,,104,156,0.667,0.667,33,53,0.623,51,99,150,41,22,25,18,53,241
376,Aleksej Pokusevski,PF,21,OKC,31,25,677,107,243,0.44,38,101,0.376,69,142,0.486,0.519,21,33,0.636,45,112,157,62,20,41,41,57,273
377,Jordan Poole,PG,23,GSW,73,42,2225,488,1147,0.425,188,569,0.33,300,578,0.519,0.507,311,356,0.874,30,169,199,336,58,18,235,191,1475
378,Kevin Porter Jr.,PG,22,HOU,50,50,1703,323,744,0.434,111,319,0.348,212,425,0.499,0.509,177,227,0.78,67,207,274,290,66,16,167,131,934
379,Michael Porter Jr.,SF,24,DEN,55,55,1594,349,709,0.492,163,393,0.415,186,316,0.589,0.607,87,107,0.813,51,245,296,59,35,27,62,112,948
380,Otto Porter Jr.,SF,29,TOR,8,2,146,15,30,0.5,6,17,0.353,9,13,0.692,0.6,8,8,1,6,13,19,8,11,0,4,7,44
381,Bobby Portis,PF,27,MIL,60,19,1558,339,676,0.501,70,204,0.343,269,472,0.57,0.553,79,96,0.823,137,437,574,96,25,14,73,97,827
382,Kristaps Porzi??is,C,27,WAS,60,60,1963,454,930,0.488,124,331,0.375,330,599,0.551,0.555,337,398,0.847,109,400,509,156,54,94,130,187,1369
383,Micah Potter,PF,24,UTA,3,0,14,2,2,1,0,0,,2,2,1,1,0,0,,1,2,3,2,0,0,0,2,4
384,Dwight Powell,C,31,DAL,67,55,1333,176,243,0.724,0,5,0,176,238,0.739,0.724,109,160,0.681,135,155,290,61,47,25,60,191,461
385,Norman Powell,SG,29,LAC,54,7,1392,299,630,0.475,109,266,0.41,190,364,0.522,0.561,192,239,0.803,20,138,158,95,42,17,89,107,899
386,Jason Preston,PG,23,LAC,13,0,122,18,41,0.439,5,18,0.278,13,23,0.565,0.5,0,2,0,2,20,22,27,2,0,10,7,41
387,Joshua Primo,SG,20,SAS,4,0,93,9,26,0.346,3,12,0.25,6,14,0.429,0.404,7,9,0.778,2,11,13,18,1,2,11,8,28
388,Taurean Prince,SF,28,MIN,47,4,1027,154,320,0.481,65,164,0.396,89,156,0.571,0.583,48,57,0.842,13,101,114,76,24,15,62,112,421
389,Payton Pritchard,PG,25,BOS,45,2,563,80,205,0.39,42,127,0.331,38,78,0.487,0.493,11,15,0.733,22,46,68,47,14,1,31,35,213
390,Trevelin Queen,SG,25,IND,7,0,70,7,29,0.241,2,15,0.133,5,14,0.357,0.276,5,5,1,8,9,17,6,2,5,7,4,21
391,Neemias Queta,C,23,SAC,4,0,25,6,8,0.75,0,0,,6,8,0.75,0.75,0,2,0,4,5,9,1,0,1,1,7,12
392,Immanuel Quickley,PG,23,NYK,72,15,2047,345,780,0.442,137,384,0.357,208,396,0.525,0.53,159,193,0.824,52,243,295,229,63,12,82,147,986
393,Julius Randle,PF,28,NYK,73,73,2623,633,1372,0.461,212,612,0.346,421,760,0.554,0.539,391,515,0.759,139,604,743,299,47,19,208,223,1869
394,Austin Reaves,SG,24,LAL,54,12,1499,203,392,0.518,68,179,0.38,135,213,0.634,0.605,176,206,0.854,28,132,160,154,30,19,78,89,650
395,Cam Reddish,SF,23,TOT,36,20,901,128,285,0.449,44,135,0.326,84,150,0.56,0.526,57,68,0.838,16,65,81,55,37,13,43,67,357
395,Cam Reddish,SF,23,NYK,20,8,438,61,136,0.449,17,56,0.304,44,80,0.55,0.511,29,33,0.879,7,24,31,20,15,8,15,32,168
395,Cam Reddish,SF,23,POR,16,12,463,67,149,0.45,27,79,0.342,40,70,0.571,0.54,28,35,0.8,9,41,50,35,22,5,28,35,189
396,Davon Reed,SG,27,TOT,40,1,336,27,83,0.325,17,46,0.37,10,37,0.27,0.428,16,24,0.667,10,48,58,21,14,4,20,39,87
